░░░░░░░░░░░░░░░░░░░░░░░░░░░░░░░░░░░░░░░░░░░░░░░░░░
░░░░░░░░░░░░░░░░░░░░░░░░ ░░░░░        ░░░░░░░░░░░░░░░░░░░░░░
░░░░░░░░░░░░░░░░░░░░░░░░░░░           ░░░░░░░░░░░░░░░░░░░░░░
░░░░░░░░░░░░░░░░░░░░░░░░░░░           ░░░░░░░░░░░░░░░░░ ░░░░
░░░░ ░░░░ ░░░░░░░░░░░░░░░░░           ░░░░░░░░░░░ ░░░░░  ░░░
░░░░░░░░░░░░░░░░░░░░░░░░░░░           ░░░░░░░░░░░░░░░░░  ░  
░░░░░⭙░░░░░░ ░░░░░░░░░░░░░░           ░░░░░░░░░░░░░░░░░  ░  
░░░░░░░░░░░░░░░░░░░░░░░░░░░           ░░░░░░░░░░░░░░░░░░░░  
░░░ ░░░░░░░░░░░░░░░░░░░░░░░           ░░░░░░░░░░░░░░░░░░░░░░
░░░░░░░░░░░░ ░░░░░░░░░░░░░░           ░░░░░░░░░░░░░░░░░░░░░░
░░░░░░░░░░░░░░░░░░░░░░░░░░░           ░░░░░░░░         ░░░░░
░░░░░░░░░░░░░░░░░░░░░░░░░░░           ░░░░░░░░        ░░░░░░
░░░░░░░░░░░░ ░░░░░░░░░░░░░░           ░░░░░░░░        ░░ ░░░
░░░░░░░░░░░░░░░░░░░░░░░░░░░           ░ ░░░░░░        ░░░░░░
░░░░░░░░░░░░░░░░░░░░░░░░░░░           ░░░░░░░░        ░░░░░░
░░░░░░░░░░░░░░░░░░░░░░░░░░░           ░░░░░░░🐜        ░░░░░░
░░░░░░░░░░░░░░░░░ ░░░░░░░░░           ░░░░░░░░        ░░░░░░
░░░░░░░ ░░░░░░░░░░░░░░░░░░░           ░░░░░░░░        ░░░░░░
░░░░░░░░░░░░░░░░░░░░░░░░░░░        ░░░░░░░░░░░░░░░░░░░░░░░░░
░░░░░░░░░ ░░░░░░░░░░░░░░░░░░░░░░░░░░░░░░░░░░░░