░░░░░░░░░░░        ░░░░░░░░░░░░░░░ ░░░░ ░░░░░░░░░░░░░░░░ ░░░
░░░░░░░░░░░           ░░░░░░░░░░░░░░░░░░░░░░░░░░░░░░░░░░░░░░
░░░░░🐜░░░░░           ░░░░░░░░░░░░░░░ ░░░░░░░░░░░░░░░░░░░░░░
░░░░░░░░░░░            ░░░░░░░░░░░░░░░░░░░░░░░░░░░░░░░░░░░░░
░░░░░░░░░░░            ░░░░░░░░░░░░░░░░░░░░░░░░░░░░░░░░░░░░░
░░░░░░░░░░░            ░░░░░░░░░░░░░ ░░░░░░░░░░░░░░░░░░░░░░░
░░░░░░░░░░░            ░░░░░░░░░░░░░░░░░░░░░░░░░░░░░░░░░░░░░
░░░░░░░░░░░           ░░░░░  ░░░░░░░░░░░░░░░░░░░░░░░░░░░░░░░
░░░░░░░░░░░           ░░░░░░░░░░░░░░░░░░░░░░░░░░░░░ ░░░░░░░░
░░░░░░░░░░░           ░░ ░░░░░░░░░░░░░░░░░░░        ░░░░░░░░
░░░░░░░░░░░           ░░░░░░░░░░░░░░░░░░░░░░        ░░░░░░░░
░░░░░░░░░░░           ░░░░░░░░░░░░░░░░░░░░░░        ░░░░░░░░
░░░░░░░░░░░           ░░░░░░░░░░░░░░░░░░░░░░        ░░░░░░░░
 ░░░░░░░░░░           ░░░░░░░░░░░░░░░░░░░░░░        ░░░░░░░░
░░░░░░░░░░░           ░░░░░░░░░░░░░░░░░░░░░░        ░░⭙░░░░░
░░░░░░░░░░░           ░░░░░░░ ░░░░░░░ ░░░░░░        ░░░░░░░░
░░░░░░░░░░░           ░░░░░░ ░░░░░░ ░░░░░░░░        ░░░░░░░░
░░░░░░░░░░░░░░        ░░░░░░░░░░░░░░░░░░░░░░░░░  ░░░░░░░░░░░
░░░░░░░░░░░░░░░░░░░░░░░░░░░░░░░░░░░░░░░░░░ ░░░░  ░░░░░░░░░░░
░░░░░░░░░░░░░░░ ░░░░░░░░░░░░░░░ ░░░░░░░░░░░░░░░  ░░░░░░░░░░░