░░░░░░░░░░░░░░░░░░░░░        ░░░░░░  ░░░░░░░░░░░░░░░░░░░░░░░
░░░░░░░░░░░░░░░░░░░░░        ░░░░    ░░░░░░░░░░░░░░░░░░░░░░░
░░░░░░░░░░░░░░░░░░░░░         ░░░    ░░░░░░░░░░░░░░░░░░░░░░░
░░░░░░░░░░░░░░░░░░░░░        ░░░░  ░        ░ ░ ░░░░░░░░░░░░
░░░░░░░░░░░░░░░░░░░░░         ░░░░░░        ░░░░░░░░░░░░░░░░
░░░░░░░░░░░░░░░░░░░░░        ░░░░░░░        ░░░░░░░░░░░░░░░░
░░░░░░░░░░░░░░░░░░░░░        ░░░░░░░        ░░░░░░░░░░░░░░░░
░░░░░░░░░░░░░░░░░░░░░        ░░░░░░░        ░░░░░░░ ░░░ ░░░░
░░░░░░░░░░░░░░░░░░░░░        ░░░░░░░        ░░░░░░░░░░░░░░░░
░░░🐜░░░░░░░░░░░░░ ░░░        ░░░░░░░        ░░░░░░░░░░░░░░░░
░░░░░░░░░░░░░░░░░░░░░        ░░░░░░░        ░░░░░ ░░░░░░░░░░
░░░        ░░░░░░░░░░        ░░░░░░░        ░░░░░░░░░░░░░░░░
░░░        ░░░░░░░░░░        ░░░░░░░            ░░⭙░░░░░░░░░
░░░        ░░░░░░░░░░        ░░░░░░░            ░░░ ░░░░░░░░
░░░        ░░░░░░░░░░        ░░░░░░░            ░░░░░░░░░░░░
░░░        ░░░░░░░░░░        ░░ ░░░░            ░░░░░░░░░░░░
░░░        ░░░░░░░░░░        ░░ ░░░░        ░░░░░░░░░░░░░░░░
░░░        ░░░░░░░░░░░░░░░░░░░░  ░░░        ░░░░░░░░░ ░░░░░░
░░░        ░░░░░░░░░░░░░░░░░░░░  ░░░        ░░░░░░░░░░░░░░░░
░░░░░░░░░░░░░░░░░░░░░░░░░░░░░░░  ░░░        ░░░░░░░░░░░░░░░░